w w w w w w w w w w w w w w w w w w w w w w
w s E s s e w s s s s s s s w s e E s s s w
w s s k s s G s s s s s s s R s s s k s s w
w e s s E s w s s s s s s s w s s s s e s w
w w w r w w w s w r w s s s w w w g w w w w w w
w s s s s s s s R P G s s s s s s s s s s s s x
w s s s s s s s w g w s s s s s s s s s s w w w
w w r w w w s s s s w r w w w g w w w w w w
w s s s e w s s s s G E s s s s s s s s s w
w s s k s G s s s s w s k s s s s e s e s w
w e s s s w s s s s R s s E s e s s k s s w
w w w w w w w w w w w w w w w w w w w w w w
