This is a file that stores data about the level of the game.
1 1 1 1 1 1 1 1 1
1 0 0 0 0 1 0 0 1
1 0 0 0 0 0 0 0 1
1 0 0 1 0 1 0 0 1
0 0 1 0 0 0 1 0 1
0 0 0 0 1 2 1 0 1
1 0 0 0 1 1 1 0 1
1 1 0 0 0 0 0 0 1
1 0 1 0 1 0 1 0 1
1 0 0 0 0 0 0 0 1
1 1 1 1 1 1 1 1 1
